{
	"title": "starter world",
	"texW": 32,
	"texH": 32,
	"textures": [
		"rock.png",
		"11.png",
		"12.png",
		"13.png",
		"63.png",
		"flowers.png",
		"brick.png",
		"sm64skybox2.png",
		"fungly.png"
	],
	"tiles": [],
	"blocks": [
		{
			"render":1,
			"texture":[0],
			"luminance":0
		},
		{
			"render":1,
			"texture":[1],
			"luminance":0
		},
		{
			"render":1,
			"texture":[2,1],
			"luminance":0
		},
		{
			"render":1,
			"texture":[3],
			"luminance":0
		},
		{
			"render":1,
			"texture":[4],
			"luminance":15
		},
		{
			"render":1,
			"texture":[5],
			"luminance":0
		},
		{
			"render":1,
			"texture":[6],
			"luminance":0.0
		}
	],
	"floorTex":5,
	"ceilTex":0,
	"skybox":7,
	"gridW": 24,
	"grid": [
		0,0,0,1,1,1,1,1,1,1,1,0,1,0,1,0,1,1,1,1,1,1,1,1,
		0,0,0,0,0,0,0,0,0,0,0,0,0,0,0,0,0,0,0,0,0,0,0,1,
		1,0,0,0,0,0,0,0,0,0,0,0,0,0,0,0,0,0,0,0,0,0,0,1,
		1,0,0,0,0,0,0,0,0,0,0,0,0,0,0,0,0,0,0,0,0,0,0,1,
		1,0,0,0,0,0,2,2,2,2,2,0,0,0,0,3,0,3,0,3,0,0,0,1,
		1,0,0,0,0,0,2,0,0,0,2,0,0,0,0,0,0,0,0,0,0,0,0,0,
		1,0,0,0,0,0,2,0,0,0,2,0,0,0,0,3,0,0,0,3,0,0,0,0,
		1,0,0,0,0,0,2,0,0,0,2,0,0,0,0,0,0,0,0,0,0,0,0,0,
		1,0,0,0,0,0,2,2,0,2,2,0,0,0,0,3,0,3,0,3,0,0,0,1,
		1,0,0,0,0,0,0,0,0,0,0,0,0,0,0,0,0,0,0,0,0,0,0,1,
		1,0,0,0,0,0,0,0,0,0,0,0,0,5,0,0,0,0,0,0,0,0,0,1,
		1,0,0,0,0,0,0,0,0,0,0,0,0,0,0,0,0,0,0,0,0,0,0,1,
		1,0,0,0,0,0,0,0,0,0,0,0,0,0,0,0,0,0,0,0,0,0,0,1,
		1,0,0,0,0,0,0,0,0,0,0,0,0,0,0,0,0,0,0,0,0,0,0,1,
		1,0,0,0,0,0,0,0,0,0,0,0,0,0,0,0,0,0,0,0,0,0,0,1,
		1,0,0,0,0,0,0,0,0,0,0,0,0,0,0,0,0,0,0,0,0,0,0,1,
		1,4,4,4,4,4,4,4,4,0,0,0,0,0,0,0,5,0,0,0,0,0,0,1,
		1,4,0,4,0,0,0,0,4,0,0,0,0,0,0,0,0,0,0,0,0,0,0,1,
		1,4,0,0,0,0,5,0,4,0,0,0,0,0,0,0,0,0,0,0,0,0,0,1,
		1,4,0,4,0,0,0,0,4,0,0,0,0,0,0,0,0,0,0,0,0,0,0,1,
		1,4,0,4,4,4,4,4,4,0,0,0,0,0,0,0,0,0,0,0,0,0,0,1,
		1,4,0,0,0,0,0,0,0,0,0,0,0,0,0,0,0,0,0,0,0,0,0,0,
		1,4,4,4,4,4,4,4,4,0,0,0,0,0,0,0,0,0,0,0,0,0,0,0,
		1,1,1,1,1,1,1,1,1,1,1,0,0,1,1,1,1,1,1,1,1,0,0,0
	],
	"floor": [
		5
	],
	"ceil": [
		1,0,0
	],
	"object": [
		{"x":11 ,"y":11,"z":0,"d":0,"tile":9}
	]
}